login,gist_created_at,gist_updated_at,files_total_size,history_total,history_additions,history_deletions,history_changes,gist_difference_at
simonharrer,2012-10-31,2020-04-06,1051,50,50,0,1,2714 days
jtornero,2015-09-16,2020-12-30,4090,84,84,0,1,1932 days
wpoely86,2014-12-21,2020-01-22,15756,196,195,1,6,1858 days
simonharrer,2012-11-30,2017-09-13,13634,302,299,3,8,1748 days
simonharrer,2011-06-03,2015-09-25,402,16,16,0,1,1575 days
simonharrer,2011-08-26,2015-09-26,652,29,29,0,1,1492 days
simonharrer,2016-12-07,2020-11-12,6238,271,239,32,3,1436 days
simonharrer,2011-10-28,2015-09-27,1003,46,46,0,1,1430 days
simonharrer,2011-12-27,2015-09-29,1812,58,58,0,1,1372 days
simonharrer,2012-03-05,2015-10-01,308,23,23,0,1,1305 days
simonharrer,2012-06-20,2015-10-06,1587,50,50,0,1,1203 days
simonharrer,2012-06-21,2015-10-06,2254,72,72,0,1,1202 days
Siedlerchr,2017-07-12,2020-09-30,11883,334,333,1,2,1176 days
simonharrer,2012-07-23,2015-10-07,86,3,3,0,1,1171 days
simonharrer,2012-10-12,2015-10-11,1766,54,54,0,1,1094 days
simonharrer,2012-11-05,2015-10-12,181,6,5,1,2,1071 days
simonharrer,2012-11-05,2015-10-12,165,5,4,1,4,1071 days
simonharrer,2012-11-05,2015-10-12,296,5,5,0,3,1071 days
simonharrer,2012-11-05,2015-10-12,398,8,8,0,1,1071 days
simonharrer,2012-11-05,2015-10-12,442,8,8,0,1,1071 days
simonharrer,2013-01-08,2015-12-10,612,58,45,13,2,1066 days
simonharrer,2013-01-21,2015-12-11,246,15,15,0,1,1054 days
simonharrer,2013-01-29,2015-12-11,457,54,37,17,3,1046 days
simonharrer,2012-12-03,2015-10-13,409,31,23,8,4,1044 days
simonharrer,2013-04-12,2015-12-16,526,33,33,0,1,978 days
igorsteinmacher,2013-10-16,2015-12-25,12905,225,142,83,10,800 days
jtornero,2014-01-16,2016-01-03,425,18,17,1,2,717 days
NicosPavlov,2014-01-16,2016-01-03,534,17,15,2,2,717 days
olenz,2014-02-14,2015-08-29,428559,251,250,1,3,561 days
matthiasgeiger,2014-02-19,2015-08-29,3600,53,53,0,1,556 days
jtornero,2014-03-11,2015-08-29,10718,121,121,0,1,536 days
jtornero,2014-03-12,2015-08-29,8551,72,72,0,1,535 days
jtornero,2014-03-12,2015-08-29,639,29,29,0,1,535 days
wpoely86,2014-03-13,2015-08-29,11384,220,220,0,1,534 days
jtornero,2014-03-19,2015-08-29,2279,94,94,0,1,528 days
wpoely86,2014-04-02,2015-08-29,663,12,12,0,1,514 days
simonharrer,2014-04-06,2015-08-29,870,33,33,0,1,510 days
jtornero,2014-04-29,2015-08-29,57312,602,602,0,1,487 days
boceckts,2019-04-16,2020-08-05,289,15,15,0,1,477 days
boceckts,2019-04-16,2020-08-05,182,11,11,0,1,477 days
jtornero,2014-05-30,2015-08-29,59794,185,185,0,1,456 days
jtornero,2014-06-08,2015-08-29,198,14,11,3,2,447 days
jtornero,2014-06-11,2015-08-29,1357,30,30,0,2,444 days
wpoely86,2014-06-18,2015-08-29,3821,123,123,0,1,437 days
wpoely86,2014-06-20,2015-08-29,1231,49,49,0,1,435 days
wpoely86,2014-07-18,2015-08-29,3073,79,79,0,1,407 days
jtornero,2014-07-19,2015-08-29,2428,22,22,0,1,406 days
wpoely86,2014-08-28,2015-08-29,14829,476,452,24,3,366 days
jtornero,2014-09-01,2015-08-29,3391,72,72,0,1,362 days
stefan-kolb,2014-09-26,2015-08-29,16520,169,169,0,1,337 days
halirutan,2014-10-09,2015-08-29,2584,73,73,0,1,324 days
jtornero,2014-11-13,2015-08-29,604833,3876,3876,0,1,289 days
wpoely86,2014-11-18,2015-08-29,11526,315,315,0,1,284 days
egonw,2018-03-04,2018-11-28,2713,161,130,31,5,269 days
jtornero,2015-02-06,2015-08-29,3060,75,75,0,1,204 days
egonw,2016-07-02,2017-01-22,1342,44,42,2,4,204 days
jtornero,2015-02-10,2015-08-29,3475,97,97,0,1,200 days
wpoely86,2015-02-11,2015-08-29,9372,287,287,0,1,199 days
wpoely86,2015-02-11,2015-08-29,26832,779,779,0,1,199 days
jtornero,2015-02-13,2015-08-29,773,24,23,1,2,197 days
KOLANICH,2017-11-09,2018-05-25,2163,34,34,0,1,197 days
wpoely86,2015-03-02,2015-08-29,3075,80,80,0,1,180 days
jtornero,2015-03-18,2015-08-29,743,19,19,0,1,164 days
stefan-kolb,2015-03-25,2015-08-29,788,22,21,1,2,157 days
IngvarJackal,2015-03-29,2015-08-29,1727,31,31,0,1,153 days
jtornero,2015-06-12,2015-08-29,3077,86,86,0,1,78 days
jtornero,2015-06-13,2015-08-29,549,16,16,0,1,77 days
jtornero,2015-06-13,2015-08-29,687,22,22,0,1,77 days
boceckts,2021-02-17,2021-04-30,281,16,16,0,1,72 days
boceckts,2021-02-17,2021-04-30,192,10,10,0,1,72 days
egonw,2019-10-19,2019-12-14,1445,75,61,14,6,56 days
egonw,2016-12-11,2017-01-14,246,21,14,7,2,34 days
halirutan,2018-06-06,2018-07-09,9757,108,89,19,10,33 days
KOLANICH,2020-08-01,2020-08-31,7984,157,157,0,1,30 days
simonharrer,2015-08-05,2015-08-29,567,13,13,0,1,24 days
IngvarJackal,2015-08-11,2015-08-29,2548,89,89,0,3,18 days
egonw,2016-08-29,2016-09-15,2654,122,96,26,6,17 days
KOLANICH,2021-02-01,2021-02-06,2198,54,54,0,1,5 days
egonw,2016-12-27,2017-01-01,762,35,32,3,2,5 days
koppor,2015-10-09,2015-10-13,1057,22,21,1,2,4 days
egonw,2017-01-05,2017-01-08,1051,33,29,4,7,3 days
IngvarJackal,2017-11-13,2017-11-15,1330,61,53,8,4,2 days
egonw,2017-09-12,2017-09-14,28550,770,711,59,4,2 days
jtornero,2019-11-15,2019-11-17,1773,62,61,1,3,2 days
jtornero,2020-02-06,2020-02-07,25257,359,331,28,2,1 days
simonharrer,2018-06-03,2018-06-04,1800,128,92,36,6,1 days
egonw,2018-12-26,2018-12-27,1609,47,43,4,3,1 days
egonw,2021-04-05,2021-04-06,2052,16,16,0,2,1 days
egonw,2016-11-28,2016-11-29,1590,47,42,5,5,1 days
egonw,2017-09-14,2017-09-15,2542,87,82,5,3,1 days
jtornero,2021-04-27,2021-04-28,406,28,21,7,2,1 days
jtornero,2018-05-17,2018-05-18,3206,135,128,7,4,1 days
simonharrer,2018-06-03,2018-06-04,2541,113,83,30,3,1 days
egonw,2019-07-13,2019-07-14,1339,46,46,0,2,1 days
egonw,2018-09-17,2018-09-18,3753,103,102,1,3,1 days
simonharrer,2018-06-03,2018-06-04,1969,73,63,10,2,1 days
egonw,2020-01-27,2020-01-28,643,12,12,0,2,1 days
egonw,2016-04-07,2016-04-07,504,14,14,0,1,0 days
egonw,2016-04-16,2016-04-16,11149,286,286,0,1,0 days
jtornero,2021-04-15,2021-04-15,1788,59,55,4,2,0 days
jtornero,2021-04-15,2021-04-15,5243,119,119,0,1,0 days
egonw,2016-04-22,2016-04-22,1475,44,44,0,2,0 days
jtornero,2021-02-15,2021-02-15,3552,24,24,0,1,0 days
jtornero,2017-03-28,2017-03-28,326,1,1,0,1,0 days
jtornero,2021-03-08,2021-03-08,11601,280,278,2,2,0 days
jtornero,2019-03-06,2019-03-06,1473,55,55,0,1,0 days
jtornero,2020-11-13,2020-11-13,5644,198,198,0,2,0 days
jtornero,2020-11-04,2020-11-04,1480,51,45,6,2,0 days
jtornero,2020-08-21,2020-08-21,396,12,12,0,1,0 days
jtornero,2020-06-26,2020-06-26,2037,47,47,0,2,0 days
jtornero,2020-05-04,2020-05-04,3199,58,53,5,3,0 days
jtornero,2020-02-21,2020-02-21,8670,216,209,7,2,0 days
jtornero,2019-07-22,2019-07-22,3836,95,95,0,1,0 days
jtornero,2018-10-03,2018-10-03,15014,724,724,0,1,0 days
jtornero,2015-09-28,2015-09-28,317,11,11,0,1,0 days
jtornero,2018-05-29,2018-05-29,510,14,13,1,2,0 days
jtornero,2018-05-17,2018-05-17,2778,42,42,0,1,0 days
jtornero,2018-02-06,2018-02-06,24166,27,27,0,2,0 days
jtornero,2017-06-26,2017-06-26,1330,22,22,0,1,0 days
jtornero,2017-03-24,2017-03-24,2257,65,65,0,1,0 days
jtornero,2016-07-14,2016-07-14,10099,335,335,0,1,0 days
jtornero,2016-06-25,2016-06-25,9844,278,278,0,1,0 days
koppor,2018-02-16,2018-02-16,3078,66,66,0,1,0 days
halirutan,2018-06-22,2018-06-22,908,1,1,0,1,0 days
solrex,2017-07-30,2017-07-30,6766,196,196,0,1,0 days
halirutan,2018-06-11,2018-06-11,1589,89,73,16,2,0 days
halirutan,2017-09-10,2017-09-10,1043,40,40,0,1,0 days
halirutan,2017-09-05,2017-09-05,2101,66,66,0,1,0 days
halirutan,2017-04-30,2017-04-30,411,18,18,0,1,0 days
halirutan,2017-02-25,2017-02-25,2480,90,90,0,1,0 days
halirutan,2016-12-25,2016-12-25,30899,227,227,0,1,0 days
halirutan,2016-11-24,2016-11-24,2874,109,97,12,2,0 days
halirutan,2016-11-22,2016-11-22,2790,87,87,0,1,0 days
wpoely86,2021-02-09,2021-02-09,1375,43,43,0,1,0 days
wpoely86,2018-01-24,2018-01-24,735,31,31,0,1,0 days
wpoely86,2016-03-01,2016-03-01,1474640,38590,38590,0,1,0 days
wpoely86,2016-02-15,2016-02-15,393793,8569,8569,0,2,0 days
IngvarJackal,2016-09-04,2016-09-04,22661,1411,815,596,5,0 days
IngvarJackal,2016-06-07,2016-06-07,1093,34,34,0,1,0 days
IngvarJackal,2016-04-16,2016-04-16,1235,56,56,0,1,0 days
IngvarJackal,2016-04-12,2016-04-12,1552,55,55,0,1,0 days
IngvarJackal,2016-04-12,2016-04-12,4718,141,141,0,1,0 days
IngvarJackal,2015-12-22,2015-12-22,4785,141,141,0,1,0 days
halirutan,2017-10-10,2017-10-10,3412,85,85,0,1,0 days
halirutan,2018-06-11,2018-06-11,424,27,22,5,2,0 days
halirutan,2020-11-20,2020-11-20,3045,62,62,0,1,0 days
egonw,2016-05-21,2016-05-21,7372,147,147,0,1,0 days
halirutan,2020-11-17,2020-11-17,6048,234,233,1,2,0 days
halirutan,2020-10-15,2020-10-15,891,114,71,43,2,0 days
halirutan,2020-10-14,2020-10-14,605,21,21,0,1,0 days
halirutan,2020-10-09,2020-10-09,1071,68,68,0,1,0 days
halirutan,2020-06-03,2020-06-03,198,11,11,0,1,0 days
halirutan,2020-05-30,2020-05-30,507,25,25,0,1,0 days
halirutan,2020-04-09,2020-04-09,1186,50,50,0,1,0 days
halirutan,2020-03-09,2020-03-09,3635,116,116,0,1,0 days
halirutan,2019-03-28,2019-03-28,3192,111,111,0,1,0 days
halirutan,2019-03-18,2019-03-18,4613,108,108,0,1,0 days
halirutan,2019-03-14,2019-03-14,4004,118,118,0,1,0 days
halirutan,2019-02-25,2019-02-25,6498,396,396,0,1,0 days
halirutan,2018-12-04,2018-12-04,48065,654,653,1,2,0 days
halirutan,2018-08-23,2018-08-23,5036,65,65,0,1,0 days
halirutan,2018-08-22,2018-08-22,4092127,6749,6749,0,1,0 days
halirutan,2018-08-15,2018-08-15,993630,20981,20981,0,1,0 days
halirutan,2018-08-13,2018-08-13,2185760,6749,6749,0,1,0 days
egonw,2016-05-18,2016-05-18,35473,7791,5193,2598,2,0 days
egonw,2017-06-11,2017-06-11,194,7,7,0,1,0 days
egonw,2016-07-01,2016-07-01,559,14,14,0,1,0 days
egonw,2019-08-17,2019-08-17,581,15,14,1,2,0 days
egonw,2021-04-23,2021-04-23,782,14,14,0,1,0 days
egonw,2021-02-15,2021-02-15,577,16,16,0,1,0 days
egonw,2021-01-19,2021-01-19,517,14,14,0,1,0 days
egonw,2020-11-02,2020-11-02,438,17,17,0,1,0 days
egonw,2020-09-20,2020-09-20,169,2,2,0,1,0 days
egonw,2020-08-30,2020-08-30,24479,167,167,0,1,0 days
egonw,2020-07-29,2020-07-29,2115,71,69,2,2,0 days
egonw,2020-07-24,2020-07-24,641,18,18,0,1,0 days
egonw,2019-12-29,2019-12-29,290898,3708,3708,0,1,0 days
egonw,2019-09-24,2019-09-24,1238,41,41,0,1,0 days
egonw,2019-08-20,2019-08-20,757,16,16,0,1,0 days
egonw,2019-08-11,2019-08-11,1321,43,43,0,1,0 days
egonw,2016-07-08,2016-07-08,2753,95,91,4,3,0 days
egonw,2019-07-18,2019-07-18,487,12,12,0,1,0 days
egonw,2019-07-14,2019-07-14,638,35,29,6,5,0 days
egonw,2019-06-22,2019-06-22,274,7,7,0,1,0 days
egonw,2019-06-15,2019-06-15,756,20,20,0,1,0 days
egonw,2019-04-20,2019-04-20,802,44,44,0,1,0 days
egonw,2019-04-13,2019-04-13,3358,20,20,0,1,0 days
egonw,2019-04-10,2019-04-10,673,202,130,72,7,0 days
egonw,2019-04-02,2019-04-02,843,40,31,9,5,0 days
egonw,2019-03-28,2019-03-28,322,9,9,0,3,0 days
egonw,2019-01-20,2019-01-20,801,34,34,0,1,0 days
egonw,2019-01-13,2019-01-13,351,9,9,0,1,0 days
KOLANICH,2017-02-07,2017-02-07,6065,63,63,0,1,0 days
KOLANICH,2017-02-07,2017-02-07,5883,62,62,0,1,0 days
KOLANICH,2018-04-04,2018-04-04,4335,133,133,0,1,0 days
KOLANICH,2020-06-16,2020-06-16,1264,547,150,397,10,0 days
koppor,2015-12-06,2015-12-06,749,21,21,0,1,0 days
Siedlerchr,2020-06-08,2020-06-08,1571,130,93,37,4,0 days
Siedlerchr,2020-04-06,2020-04-06,1272,18,18,0,1,0 days
Siedlerchr,2020-03-13,2020-03-13,48435,1735,1735,0,2,0 days
Siedlerchr,2020-02-07,2020-02-07,1356,19,19,0,1,0 days
Siedlerchr,2018-05-23,2018-05-23,2304,83,83,0,1,0 days
Siedlerchr,2018-05-23,2018-05-23,1177,45,45,0,1,0 days
Siedlerchr,2017-12-23,2017-12-23,5564,311,268,43,5,0 days
Siedlerchr,2017-10-14,2017-10-14,1370,37,37,0,1,0 days
Siedlerchr,2017-07-20,2017-07-20,1476,61,61,0,1,0 days
tobiasdiez,2018-11-16,2018-11-16,4323,154,145,9,2,0 days
simonharrer,2018-06-03,2018-06-03,444,7,7,0,1,0 days
simonharrer,2016-12-21,2016-12-21,10437,310,290,20,5,0 days
simonharrer,2016-08-18,2016-08-18,4573,200,169,31,7,0 days
simonharrer,2015-09-16,2015-09-16,607,34,34,0,1,0 days
LinusDietz,2016-02-24,2016-02-24,362,18,16,2,2,0 days
davidemdot,2019-08-25,2019-08-25,18745,152,152,0,1,0 days
hakova,2018-02-22,2018-02-22,3094,66,66,0,1,0 days
boceckts,2021-04-30,2021-04-30,245,9,9,0,1,0 days
boceckts,2021-03-16,2021-03-16,7347,326,326,0,1,0 days
boceckts,2018-11-26,2018-11-26,2498,60,60,0,1,0 days
igorsteinmacher,2015-10-07,2015-10-07,19905,339,339,0,1,0 days
chelseyong,2019-10-26,2019-10-26,3168,108,108,0,1,0 days
egonw,2018-12-30,2018-12-30,2239,112,95,17,2,0 days
egonw,2018-12-04,2018-12-04,244,4,4,0,1,0 days
egonw,2018-11-30,2018-11-30,823,24,24,0,1,0 days
egonw,2017-09-27,2017-09-27,2142,61,61,0,1,0 days
egonw,2017-08-18,2017-08-18,5596,86,86,0,1,0 days
egonw,2017-07-30,2017-07-30,13569,195,194,1,3,0 days
egonw,2017-06-23,2017-06-23,1376,44,44,0,4,0 days
koppor,2017-02-08,2017-02-08,753,57,41,16,2,0 days
egonw,2017-05-26,2017-05-26,407,16,13,3,2,0 days
egonw,2017-05-17,2017-05-17,512,21,21,0,1,0 days
egonw,2017-01-28,2017-01-28,1571,51,51,0,1,0 days
egonw,2017-01-01,2017-01-01,246331,3243,3243,0,2,0 days
egonw,2017-01-01,2017-01-01,163076,19371,11055,8316,3,0 days
egonw,2016-12-31,2016-12-31,5343,57,40,17,2,0 days
egonw,2016-12-31,2016-12-31,457,4,4,0,2,0 days
egonw,2016-12-30,2016-12-30,820,26,26,0,1,0 days
egonw,2016-12-02,2016-12-02,711,17,17,0,1,0 days
egonw,2016-11-27,2016-11-27,529,16,16,0,1,0 days
egonw,2016-11-16,2016-11-16,342,9,9,0,1,0 days
egonw,2016-10-31,2016-10-31,2163,36,36,0,1,0 days
egonw,2016-09-03,2016-09-03,1529,46,46,0,1,0 days
egonw,2016-08-31,2016-08-31,3546,46,46,0,1,0 days
egonw,2016-08-31,2016-08-31,22164,262,262,0,2,0 days
egonw,2016-08-28,2016-08-28,21061,248,248,0,1,0 days
egonw,2016-08-26,2016-08-26,14247,178,178,0,1,0 days
egonw,2016-08-20,2016-08-20,618,33,25,8,2,0 days
egonw,2016-08-10,2016-08-10,332,32,32,0,2,0 days
egonw,2017-09-14,2017-09-14,677,43,43,0,1,0 days
egonw,2017-10-29,2017-10-29,2459,88,88,0,1,0 days
egonw,2018-11-29,2018-11-29,1275,57,42,15,5,0 days
egonw,2017-12-22,2017-12-22,981,21,21,0,1,0 days
egonw,2018-11-25,2018-11-25,3393,57,57,0,2,0 days
egonw,2018-11-20,2018-11-20,575,19,19,0,1,0 days
egonw,2018-11-13,2018-11-13,82798,669,669,0,2,0 days
egonw,2018-11-13,2018-11-13,852,28,28,0,1,0 days
egonw,2018-11-04,2018-11-04,799,1,1,0,1,0 days
egonw,2018-11-03,2018-11-03,603,20,20,0,1,0 days
egonw,2018-11-03,2018-11-03,451,11,11,0,1,0 days
egonw,2018-10-10,2018-10-10,276,6,6,0,1,0 days
egonw,2018-09-28,2018-09-28,1252,56,56,0,2,0 days
egonw,2018-09-12,2018-09-12,2342,62,62,0,2,0 days
egonw,2018-09-05,2018-09-05,398,9,9,0,1,0 days
egonw,2018-09-02,2018-09-02,541,21,21,0,1,0 days
egonw,2018-08-19,2018-08-19,528,15,15,0,1,0 days
egonw,2018-08-19,2018-08-19,531,15,15,0,1,0 days
egonw,2018-07-24,2018-07-24,266,19,19,0,1,0 days
egonw,2018-06-30,2018-06-30,2132,81,81,0,1,0 days
egonw,2018-06-30,2018-06-30,2045,81,80,1,3,0 days
egonw,2018-06-29,2018-06-29,1107,33,33,0,1,0 days
egonw,2018-06-21,2018-06-21,3608,129,129,0,1,0 days
egonw,2018-06-21,2018-06-21,967,30,30,0,1,0 days
egonw,2018-06-03,2018-06-03,688,21,21,0,1,0 days
egonw,2018-05-21,2018-05-21,425,13,13,0,1,0 days
egonw,2018-01-05,2018-01-05,4406,146,144,2,2,0 days
tolot27,2020-11-24,2020-11-24,601,12,11,1,3,0 days
